
C 0,255,255
F 101,67,33






NO ./texturs/wall.xpm
SO ./texturs/wall.xpm
WE ./texturs/wall.xpm
EA ./texturs/wall.xpm

11111111111111
10000000000001
1N000000000101
11111111111111