
F 220,100,255
C 225,30,0






NO ./texturs/wall.xpm
SO ./texturs/wall.xpm
WE ./texturs/wall.xpm
EA ./texturs/wall.xpm

11111111111111
10000000000001
1S000000000101
10000001000001
11111111110111
10000000000001
11111111111111