C 60,10,25
F 30,30,30


NO ./texturs/w1.xpm
SO ./texturs/w2.xpm
WE ./texturs/w3.xpm
EA ./texturs/w4.xpm

        1111111111111111111111111
        1000000000110000000000001
        1011000001110000000000001
        1001000000000000000000001
111111111011000001110000000000001
100000000011000001110111111111111
11110111111111011100000010001
11110111111111011101010010001
11000000110101011100000010001
10000000000000001100000010001
10000000000000001101010010001
1100000111010101111101111000111
11110111 1110101 101111010001
11111111 1111111 111111111111
        1111111111111111111111111
        1111111111111111111101111
        1000000000110000000000001
        1011000001110000000000001
        1001000000000000000000001
11111111 11111111111111111111111
11111111 11111111111111111111111
111111111011000001110000000000001
100000000011000001110111111111111
11110111111111011100000010001
11110010010000000101010010001
1100000010000S000000000010001
10000100000000001100000010001
10000100010000001101010010001
1100000111010101111101111000111
11110111 1110101 101111010001
11111111 1111111 111111111111