
F 220,100,255
C 225,30,0

NO ./texturs/wall.xpm
SO ./texturs/wall.xpm
WE ./texturs/wall.xpm
EA ./texturs/wall.xpm

        11111111111111111111111111
        1111111111111111111101111
        1000000000110000000000001
        1011000001110000000000001
        1001000000000000000000001
111111111011000001110000000000001
100000000011000001110111111111111
11110111111111011100000010001
11110111111111011101010010001
11000000110101011100000010001
10000000000000001100000010001
10000000000000001101010010001
1100000111010101111101111000111
11110111 1110101 101111010001
11111111 1111111 111111111111
        1111111111111111111111111
        1111111111111111111101111
        1000000000110000000000001
        1011000001110000000000001111
        1001000000000000000000001
111111111011000001110000000000001
100000000011000001110111111111111
11110111111111011100000010001
11110111111111011101010010001
11000000110101011100100010001
100000000000000011000S0010001
10000000000000001101010010001
11000001110101011111011110001
11110111 1110101 101111010001
11111111 1111111 111111111111